1 13 31
###############################
#psbf   * *    *   *  * * *   #
#       # # #*#*# # # #*#*#*# #
#  x*    2***  *      *   * * #
# # # # # #*# # #*#*# # # # #*#
#f     1   x **  *  *         #
# # # # # # # # # #*# #*# # # #
#*  *                         #
# # # # #*# # # #*#*# # # # # #
#*    **  *       *           #
# #*# # # # # # #*# # # # # # #
#           *   *  *          #
###############################